1111111111
10000000E1
1011111111
10010000C1
1101011111
1000P00001
1011011101
101C100001
1C10001C11
1111111111