1111111111
1P0C000E01
1000111111
100C10C0C1
1111111111