1111111111
1P1C001E01
1010101101
100010C001
1111111111