1111111111
1PCCCE11C1
1111111111
